05 05 05 05 05 05 05 05 05 05 05 05 05 05 05 05 05 05 05 05 05 05 05 05 05 05 05 00 00 00 00 00 00 05 05 05 05 05 05 05 05 00 00 05 05 05 05 05 05 05 05 00 00 05 05 05 05 05 05 05 05 05 05 05 05 05 05 05 05 05 05
05 05 05 05 05 05 05 05 05 05 05 05 05 05 05 05 05 05 05 05 05 05 05 05 05 05 05 00 00 00 00 00 00 05 05 05 05 05 05 05 05 00 00 05 05 05 05 05 05 05 05 00 00 05 05 05 05 05 05 05 05 05 05 05 05 05 05 05 05 05 05
05 00 00 00 00 00 00 00 00 00 00 00 00 00 00 00 00 00 00 00 00 00 00 00 00 00 05 00 00 00 00 00 00 05 00 00 00 00 00 00 00 00 00 00 00 00 00 00 00 00 05 00 00 05 00 00 00 00 00 00 00 00 00 00 00 00 00 00 00 00 05
05 00 19 19 19 19 19 19 19 19 19 19 19 00 19 19 19 19 19 00 00 00 00 00 00 00 05 00 00 00 00 00 00 05 00 00 03 00 00 00 00 00 00 00 00 00 00 00 00 00 05 00 00 05 00 00 15 15 16 16 00 00 00 00 00 00 00 00 00 00 05
05 00 19 17 17 17 17 17 17 17 17 17 19 00 19 17 17 17 19 00 00 00 20 20 00 00 05 00 00 00 00 00 00 05 00 00 00 00 00 00 00 00 00 00 00 00 00 00 00 00 05 00 00 05 00 14 00 00 00 00 00 00 00 00 00 00 00 00 00 00 05
05 00 19 17 17 17 17 17 17 17 17 17 19 00 19 17 17 17 19 00 00 00 20 20 00 00 05 00 00 00 00 00 00 05 00 00 00 00 00 00 00 00 00 00 00 00 00 00 00 00 05 00 00 05 00 14 00 00 00 00 00 00 00 00 00 00 00 00 00 00 05
05 00 19 17 17 17 17 17 17 17 17 17 19 00 19 17 18 17 19 00 00 00 00 00 00 00 05 00 00 00 00 00 00 05 00 00 00 00 00 00 00 00 00 00 00 00 00 00 00 00 05 00 00 05 00 00 00 00 00 00 00 00 00 00 00 00 00 00 00 00 05
05 00 19 17 17 17 17 17 17 17 17 17 19 00 19 17 17 17 19 00 00 00 00 00 00 00 05 05 05 05 05 05 05 05 00 00 00 00 00 00 00 00 00 00 00 00 00 00 00 00 05 05 05 05 00 00 00 00 00 00 00 00 00 00 00 00 00 00 00 00 05
05 00 19 17 17 17 17 18 17 17 17 17 19 00 19 17 17 17 19 00 00 00 00 00 00 00 00 00 00 00 00 00 00 00 00 00 00 00 00 00 00 00 00 00 00 00 00 00 00 00 00 00 00 00 00 00 00 00 00 00 00 00 00 00 00 00 00 00 00 00 05
05 00 19 17 17 17 17 17 17 17 17 17 19 00 19 19 19 19 19 00 00 00 00 00 00 00 00 00 00 00 00 00 00 00 00 00 00 00 00 00 00 00 00 00 00 00 00 00 00 00 00 00 00 00 00 00 00 00 00 00 00 00 00 00 00 00 00 00 12 00 05
05 00 19 17 17 17 17 17 17 17 17 17 19 00 00 00 00 00 00 00 00 00 00 00 00 00 05 05 05 05 05 05 05 05 00 00 00 00 00 00 00 00 00 00 00 00 00 00 00 00 05 05 05 05 00 00 00 00 00 00 00 00 00 00 00 00 00 00 13 00 05
05 00 19 17 17 17 17 17 17 17 17 17 19 00 19 19 19 19 19 00 00 00 00 00 00 00 05 00 00 00 00 00 00 05 00 00 00 00 00 00 00 00 00 00 00 00 00 00 00 00 05 00 00 05 00 00 00 00 00 00 00 00 00 00 00 00 00 00 00 00 05
05 00 19 17 17 17 17 17 17 17 17 17 19 00 19 17 17 17 19 00 00 00 00 00 00 00 05 00 00 00 00 00 00 05 00 00 00 00 00 00 00 00 00 00 00 00 00 00 00 00 05 00 00 05 00 00 00 00 00 00 00 00 00 00 00 00 00 00 00 00 05
05 00 19 19 19 19 19 19 19 19 19 19 19 00 19 17 17 17 19 00 00 00 00 00 00 00 05 00 00 00 00 00 00 05 00 00 00 00 00 00 00 00 00 00 00 00 00 00 00 00 05 00 00 05 00 11 00 00 00 00 00 00 00 00 00 00 00 00 00 00 05
05 00 00 00 00 00 00 00 00 00 00 00 00 00 19 17 18 17 19 00 00 00 00 00 00 00 05 00 00 00 00 00 00 05 00 04 04 00 00 00 00 00 00 00 00 00 00 00 00 00 05 00 00 05 00 00 10 00 00 00 00 00 00 08 08 09 09 00 00 00 05
05 00 19 19 19 19 19 19 19 19 19 19 19 00 19 17 17 17 19 00 00 00 00 00 00 00 05 00 00 00 00 00 00 05 00 00 00 00 00 00 00 00 00 00 00 00 00 00 00 00 05 00 00 05 00 00 00 00 00 00 00 00 00 00 00 00 00 00 00 00 05
05 00 19 17 17 17 17 17 17 17 17 17 19 00 19 17 17 17 19 00 00 00 00 00 00 00 05 00 00 00 00 00 00 05 05 05 05 05 05 05 05 05 05 05 05 05 05 05 05 05 05 00 00 05 05 05 05 05 05 05 05 05 05 05 05 05 05 05 05 05 05
05 00 19 17 17 17 17 17 17 17 17 17 19 00 19 19 19 19 19 00 00 00 00 00 00 00 05 00 00 00 00 00 00 05 05 05 05 05 05 05 05 05 05 05 05 05 05 05 05 05 05 00 00 05 05 05 05 05 05 05 05 05 05 05 05 05 05 05 05 05 05
05 00 19 17 17 17 17 17 17 17 17 17 19 00 00 00 00 00 00 00 00 00 00 00 00 00 05 00 00 00 00 00 00 00 00 00 00 00 00 00 00 00 00 00 00 00 00 00 00 00 00 00 00 00 00 00 00 00 00 00 00 00 00 00 00 00 00 00 00 00 00
05 00 19 17 17 17 17 17 17 17 17 17 19 00 19 19 19 19 19 00 00 00 00 00 00 00 05 00 00 00 00 00 00 00 00 00 00 00 00 00 00 00 00 00 00 00 00 00 00 00 00 00 00 00 00 00 00 00 00 00 00 00 00 00 00 00 00 00 00 00 00
05 00 19 17 17 17 17 18 17 17 17 17 19 00 19 17 17 17 19 00 00 00 00 00 00 00 05 00 00 00 00 00 00 00 00 00 00 00 00 00 00 00 00 00 00 00 00 00 00 00 00 00 00 00 00 00 00 00 00 00 00 00 00 00 00 00 00 00 00 00 00
05 00 19 17 17 17 17 17 17 17 17 17 19 00 19 17 17 17 19 00 00 00 00 00 00 00 05 00 00 00 00 00 00 00 00 00 00 00 00 00 00 00 00 00 00 00 00 00 00 00 00 00 00 00 00 00 00 00 00 00 00 00 00 00 00 00 00 00 00 00 00
05 00 19 17 17 17 17 17 17 17 17 17 19 00 19 17 18 17 19 00 00 00 00 00 00 00 05 00 00 00 00 00 00 00 00 00 00 00 00 00 00 00 00 00 00 00 00 00 00 00 00 00 00 00 00 00 00 00 00 00 00 00 00 00 00 00 00 00 00 00 00
05 00 19 17 17 17 17 17 17 17 17 17 19 00 19 17 17 17 19 00 00 00 00 00 00 00 05 00 00 00 00 00 00 00 00 00 00 00 00 00 00 00 00 00 00 00 00 00 00 00 00 00 00 00 00 00 00 00 00 00 00 00 00 00 00 00 00 00 00 00 00
05 00 19 17 17 17 17 17 17 17 17 17 19 00 19 17 17 17 19 00 00 00 00 00 00 00 05 00 00 00 00 00 00 00 00 00 00 00 00 00 00 00 00 00 00 00 00 00 00 00 00 00 00 00 00 00 00 00 00 00 00 00 00 00 00 00 00 00 00 00 00
05 00 19 19 19 19 19 19 19 19 19 19 19 00 19 19 19 19 19 00 00 00 00 00 00 00 05 00 00 00 00 00 00 00 00 00 00 00 00 00 00 00 00 00 00 00 00 00 00 00 00 00 00 00 00 00 00 00 00 00 00 00 00 00 00 00 00 00 00 00 00
05 00 00 00 00 00 00 00 00 00 00 00 00 00 00 00 00 00 00 00 00 00 00 00 00 00 05 00 00 00 00 00 00 00 00 00 00 00 00 00 00 00 00 00 00 00 00 00 00 00 00 00 00 00 00 00 00 00 00 00 00 00 00 00 00 00 00 00 00 00 00
05 05 05 05 05 05 05 05 05 05 05 05 05 05 05 05 05 05 05 05 05 00 00 05 05 05 05 00 00 00 00 00 00 00 00 00 00 00 00 00 00 00 00 00 00 00 00 00 00 00 00 00 00 00 00 00 00 00 00 00 00 00 00 00 00 00 00 00 00 00 00
05 05 05 05 05 05 05 05 05 05 05 05 05 05 05 05 05 05 05 05 05 00 00 05 05 05 05 00 00 00 00 00 00 00 00 00 00 00 00 00 00 00 00 00 00 00 00 00 00 00 00 00 00 00 00 00 00 00 00 00 00 00 00 00 00 00 00 00 00 00 00
00 00 00 00 00 00 00 00 00 00 00 00 00 00 00 00 00 00 00 00 05 00 00 05 00 00 00 00 00 00 00 00 00 00 00 00 00 00 00 00 00 00 00 00 00 00 00 00 00 00 00 00 00 00 00 00 00 00 00 00 00 00 00 00 00 00 00 00 00 00 00
00 00 00 00 00 00 00 00 00 00 00 00 00 00 00 00 00 00 00 00 05 00 00 05 00 00 00 00 00 00 00 00 00 00 00 00 00 00 00 00 00 00 00 00 00 00 00 00 00 00 00 00 00 00 00 00 00 00 00 00 00 00 00 00 00 00 00 00 00 00 00
00 00 00 00 00 00 00 05 05 05 05 05 05 05 05 05 05 05 05 05 05 00 00 05 05 00 00 00 00 00 00 00 00 00 00 00 00 00 00 00 00 00 00 00 00 00 00 00 00 00 00 00 00 00 00 00 00 00 00 00 00 00 00 00 00 00 00 00 00 00 00
00 00 00 00 00 00 00 05 05 05 05 05 05 05 05 05 05 05 05 05 05 00 00 05 05 00 00 00 00 00 00 00 00 00 00 00 00 00 00 00 00 00 00 00 00 00 00 00 00 00 00 00 00 00 00 00 00 00 00 00 00 00 00 00 00 00 00 00 00 00 00
00 00 00 00 00 00 00 05 00 00 00 00 00 00 00 00 00 00 00 00 00 00 00 00 05 00 00 00 00 00 00 00 00 00 00 00 00 00 00 00 00 00 00 00 00 00 00 00 00 00 00 00 00 00 00 00 00 00 00 00 00 00 00 00 00 00 00 00 00 00 00
00 00 00 00 00 00 00 05 00 19 19 19 19 19 19 00 00 19 19 19 19 19 19 00 05 00 00 00 00 00 00 00 00 00 00 00 00 00 00 00 00 00 00 00 00 00 00 00 00 00 00 00 00 00 00 00 00 00 00 00 00 00 00 00 00 00 00 00 00 00 00
00 00 00 00 00 00 00 05 00 19 23 23 23 23 19 00 00 19 25 25 25 25 19 00 05 00 00 00 00 00 00 00 00 00 00 00 00 00 00 00 00 00 00 00 00 00 00 00 00 00 00 00 00 00 00 00 00 00 00 00 00 00 00 00 00 00 00 00 00 00 00
00 00 00 00 00 00 00 05 00 19 23 23 23 23 19 00 00 19 25 25 25 25 19 00 05 00 00 00 00 00 00 00 00 00 00 00 00 00 00 00 00 00 00 00 00 00 00 00 00 00 00 00 00 00 00 00 00 00 00 00 00 00 00 00 00 00 00 00 00 00 00
00 00 00 00 00 00 00 05 00 19 23 23 23 23 19 00 00 19 25 25 25 25 19 00 05 00 00 00 00 00 00 00 00 00 00 00 00 00 00 00 00 00 00 00 00 00 00 00 00 00 00 00 00 00 00 00 00 00 00 00 00 00 00 00 00 00 00 00 00 00 00
00 00 00 00 00 00 00 05 00 19 19 19 19 19 19 00 00 19 19 19 19 19 19 00 05 00 00 00 00 00 00 00 00 00 00 00 00 00 00 00 00 00 00 00 00 00 00 00 00 00 00 00 00 00 00 00 00 00 00 00 00 00 00 00 00 00 00 00 00 00 00
00 00 00 00 00 00 00 05 00 00 00 00 00 00 00 00 00 00 00 00 00 00 00 00 05 00 00 00 00 00 00 00 00 00 00 00 00 00 00 00 00 00 00 00 00 00 00 00 00 00 00 00 00 00 00 00 00 00 00 00 00 00 00 00 00 00 00 00 00 00 00
00 00 00 00 00 00 00 05 00 19 19 19 19 19 00 00 00 00 19 19 19 19 19 00 05 00 00 00 00 00 00 00 00 00 00 00 00 00 00 00 00 00 00 00 00 00 00 00 00 00 00 00 00 00 00 00 00 00 00 00 00 00 00 00 00 00 00 00 00 00 00
00 00 00 00 00 00 00 05 00 19 22 22 22 19 00 00 00 00 19 24 24 24 19 00 05 00 00 00 00 00 00 00 00 00 00 00 00 00 00 00 00 00 00 00 00 00 00 00 00 00 00 00 00 00 00 00 00 00 00 00 00 00 00 00 00 00 00 00 00 00 00
00 00 00 00 00 00 00 05 00 19 22 22 22 19 00 00 00 00 19 24 24 24 19 00 05 00 00 00 00 00 00 00 00 00 00 00 00 00 00 00 00 00 00 00 00 00 00 00 00 00 00 00 00 00 00 00 00 00 00 00 00 00 00 00 00 00 00 00 00 00 00
00 00 00 00 00 00 00 05 00 19 22 22 22 19 00 21 00 00 19 24 24 24 19 00 05 00 00 00 00 00 00 00 00 00 00 00 00 00 00 00 00 00 00 00 00 00 00 00 00 00 00 00 00 00 00 00 00 00 00 00 00 00 00 00 00 00 00 00 00 00 00
00 00 00 00 00 00 00 05 00 19 22 22 22 19 00 00 00 00 19 24 24 24 19 00 05 00 00 00 00 00 00 00 00 00 00 00 00 00 00 00 00 00 00 00 00 00 00 00 00 00 00 00 00 00 00 00 00 00 00 00 00 00 00 00 00 00 00 00 00 00 00
00 00 00 00 00 00 00 05 00 19 19 19 19 19 00 00 00 00 19 19 19 19 19 00 05 00 00 00 00 00 00 00 00 00 00 00 00 00 00 00 00 00 00 00 00 00 00 00 00 00 00 00 00 00 00 00 00 00 00 00 00 00 00 00 00 00 00 00 00 00 00
00 00 00 00 00 00 00 05 00 00 00 00 00 00 00 00 00 00 00 00 00 00 00 00 05 00 00 00 00 00 00 00 00 00 00 00 00 00 00 00 00 00 00 00 00 00 00 00 00 00 00 00 00 00 00 00 00 00 00 00 00 00 00 00 00 00 00 00 00 00 00
00 00 00 00 00 00 00 05 05 05 05 05 05 05 05 05 05 05 05 05 05 05 05 05 05 00 00 00 00 00 00 00 00 00 00 00 00 00 00 00 00 00 00 00 00 00 00 00 00 00 00 00 00 00 00 00 00 00 00 00 00 00 00 00 00 00 00 00 00 00 00
00 00 00 00 00 00 00 05 05 05 05 05 05 05 05 05 05 05 05 05 05 05 05 05 05 00 00 00 00 00 00 00 00 00 00 00 00 00 00 00 00 00 00 00 00 00 00 00 00 00 00 00 00 00 00 00 00 00 00 00 00 00 00 00 00 00 00 00 00 00 00
00 00 00 00 00 00 00 00 00 00 00 00 00 00 00 00 00 00 00 00 00 00 00 00 00 00 00 00 00 00 00 00 00 00 00 00 00 00 00 00 00 00 00 00 00 00 00 00 00 00 00 00 00 00 00 00 00 00 00 00 00 00 00 00 00 00 00 00 00 00 00